107
8
0	0	0	0	0	0	0	0	0	0	0	0	0	0	0	0	0	0	0	0	0	0	0	0	0	0	0	0	0	0	0	0	0	0	0	0	0	0	0	0	0	0	0	0	0	0	0	0	0	0	0	0	0	0	0	0	0	0	0	0	0	0	0	0	0	0	0	0	0	0	0	0	0	0	0	0	0	0	0	0	0	0	0	0	0	0	0	0	0	0	0	0	0	0	0	0	0	0	0	0	0	0	0	0	0	3	22
0	0	0	0	0	0	0	0	0	0	0	0	0	0	0	0	0	0	0	0	0	0	0	0	0	0	0	0	0	0	0	0	0	11	10	11	10	11	0	0	0	0	0	0	0	0	0	0	0	0	0	0	0	0	0	0	0	0	0	0	0	0	0	0	0	0	0	0	0	0	0	0	0	0	0	0	0	0	0	0	0	0	0	0	0	0	0	0	0	0	0	0	0	0	0	0	0	0	0	0	0	0	0	0	0	3	22
0	0	0	0	0	0	0	0	0	0	0	0	0	0	0	0	0	0	0	0	0	0	0	0	0	0	0	0	0	0	0	0	0	23	24	24	24	25	0	0	0	0	9	10	9	10	0	0	0	0	0	0	0	0	0	0	0	0	0	0	0	0	0	0	0	0	0	0	0	0	0	0	0	0	0	10	0	0	0	0	0	0	0	0	0	0	10	0	0	0	0	0	0	0	0	0	0	0	0	0	0	0	0	0	0	3	22
0	0	0	0	0	0	0	0	0	0	0	0	0	0	0	0	0	0	0	0	0	0	0	0	0	0	0	10	9	10	9	10	0	0	0	0	0	0	0	0	0	0	23	24	24	25	0	0	0	0	0	0	0	0	0	0	0	0	0	0	9	0	10	0	0	0	0	0	0	0	0	0	0	0	23	25	0	0	0	0	0	0	0	0	1	21	21	2	0	0	0	0	0	0	0	0	0	0	0	0	0	0	0	0	0	3	22
0	0	0	0	0	0	0	0	0	0	0	0	0	0	0	0	0	0	0	0	0	0	0	0	0	0	0	23	24	24	24	25	0	0	0	0	0	0	0	10	0	0	0	0	0	0	0	0	0	0	0	0	0	0	0	0	0	0	0	1	21	21	21	2	0	0	0	0	0	0	10	10	11	0	0	0	0	0	10	0	0	23	25	0	3	22	22	4	0	0	0	0	0	0	0	0	0	0	0	0	0	0	0	0	0	3	22
0	0	9	10	9	0	0	0	0	0	0	10	0	9	10	0	0	0	0	0	11	10	11	10	11	0	0	0	0	0	0	0	0	0	0	0	0	0	1	21	21	2	0	0	0	0	0	0	9	0	0	9	0	0	0	0	9	0	11	3	22	22	22	4	11	10	11	10	0	0	23	24	25	0	0	0	0	1	21	2	9	11	11	9	3	22	22	4	11	9	9	11	9	0	0	0	0	10	0	0	0	0	0	9	0	9	22
0	23	24	24	24	24	25	0	0	0	23	24	24	24	24	25	0	0	0	23	24	24	24	24	24	25	0	0	0	0	0	0	0	0	0	0	0	0	3	22	22	4	0	0	0	0	0	1	21	21	21	21	2	0	0	1	21	21	21	21	22	22	22	21	21	21	21	21	2	0	0	0	0	0	0	0	0	3	22	21	21	21	21	21	21	22	22	21	21	21	21	21	21	2	0	0	23	25	0	0	0	1	21	21	21	21	22
0	0	0	0	0	0	0	0	0	0	0	0	0	0	0	0	0	0	0	0	0	0	0	0	0	0	0	0	0	0	0	0	0	0	0	0	0	0	3	22	22	4	0	0	0	0	0	3	22	22	22	22	4	0	0	3	22	22	22	22	22	22	22	22	22	22	22	22	4	0	0	0	0	0	0	0	0	3	22	22	22	22	22	22	22	22	22	22	22	22	22	22	22	4	0	0	0	0	0	0	0	3	22	22	22	22	22
